a=a.sups
b=b.sups
c=c.sups
d=d.sups
e=e.sups
f=f.sups
g=g.sups
h=h.sups
i=i.sups
j=j.sups
k=k.sups
l=l.sups
m=m.sups
n=n.sups
o=o.sups
p=p.sups
q=q.sups
r=r.sups
s=s.sups
t=t.sups
u=u.sups
v=v.sups
w=w.sups
x=x.sups
y=y.sups
z=z.sups
zero=zero.sups
one=one.sups
two=two.sups
three=three.sups
four=four.sups
five=five.sups
six=six.sups
seven=seven.sups
eight=eight.sups
nine=nine.sups
parenleft=parenleft.sups
parenright=parenright.sups
plus=plus.sups
minus=minus.sups
equal=equal.sups
